R    1920  1080    
NO ./textures/north.xpm
SO ./textures/south.xpm     

WE ./textures/west.xpm     
EA ./textures/east.xpm
S ./textures/barrel.xpm
F 220,100,0
C 235, 50 , 0


   1111111111111111111111111  11111
   1000000000110000000000001  10001
   1011000001110000002000001  10N01
   1001000000000000000000001  11111
1111111110110000011100000001   
10000000011000001110111111111111
11110111111111011100000010001
11110111111111011101010010001
11000000110101011100000010001
10002000000000001100000010001
10000000000000001101110010001
1100000111010101111101111000111
11110111 1110101 101111010001
11111111 1111111 111111111111