
R    1024  768

NO ./textures/north.xpm

SO ./textures/south.xpm
WE ./textures/west.xpm     
EA ./textures/east.xpm
S ./textures/barrel.xpm

C 0,164,219
F    0  ,  128    , 0



111111111111111111111
100000000000200000001
101100200111200002221 111111
100100000000000000001 100001
100111111111011101011 111111
110000001111010111001
100020000000000011001
1020000W0000000011011
100000111012101111121
111111111111111111111